111111111
111...111
1.......1
1.......1
111...111
111111111