.11...11.
1..111..1
.1.....1.
..1...1..
...1.1...
....1....